Annalen der Physik	annalen der physik
Anuario filosófico	anuario filosofico
Autonomous Underwater Vehicles, 2002. Proceedings of the 2002 Workshop on	autonomous underwater vehicles 2002 proceedings of the 2002 workshop on
America's Network	americas network
AIDS & Public Policy Journal	aids & public policy journal
AT & T Technical Journal	at & t technical journal
Accounting Educators' Journal, The	accounting educators journal the
Accounting Historians Journal, The	accounting historians journal the
A.N.A.L.O.G. Computing	a n a l o g computing
Air/Water Pollution Report	air water pollution report
Arts d'Afrique Noire	arts dafrique noire
Archivo español de arqueología	archivo espanol de arqueologia
American Legacy: Celebrating African-American History & Culture	american legacy celebrating african american history & culture
Annales d'Otolaryngologie et de chirurgie cervico-faciale	annales dotolaryngologie et de chirurgie cervico faciale
Annales de Biologie Clinique	annales de biologie clinique
Annales de Dermatologie et de Vénéréologie	annales de dermatologie et de venereologie
Annales de Géographie	annales de geographie
Annales de Kinésitherapie	annales de kinesitherapie
Annales de Médecine Interne	annales de medecine interne
Analisis y Modificacion de Conducta	analisis y modificacion de conducta
All - Canadian Money Guide	all canadian money guide
Archiv für Musikwissenschaft	archiv fur musikwissenschaft
Alaska Highway News; Fort St. John, B.C.	alaska highway news fort st john b c
Atmospheric Environment. Part A. General Topics	atmospheric environment part a general topics
Advances in the Economic Analysis of Participatory & Labor-Managed Firms	advances in the economic analysis of participatory & labor managed firms
Acta Ortopédica Brasileira	acta ortopedica brasileira
Applied Macromolecular Chemistry and Physics / Die Angewandte Makromolekulare Chemie	applied macromolecular chemistry and physics die angewandte makromolekulare chemie
Anatomia, Histologia, Embryologia: Journal of Veterinary Medicine Series C	anatomia histologia embryologia journal of veterinary medicine series c
Acta Crystallographica Section C: Crystal Structure Communications	acta crystallographica section c crystal structure communications
Advanced Research in Asynchronous Circuits and Systems, 1999. Proceedings., Fifth International Symposium on	advanced research in asynchronous circuits and systems 1999 proceedings fifth international symposium on
Advanced Semiconductor Manufacturing Conference and Workshop, 1995. ASMC 95 Proceedings. IEEE/SEMI 1995	advanced semiconductor manufacturing conference and workshop 1995 asmc 95 proceedings ieee semi 1995
All-Optical Networking: Existing and Emerging Architecture and Applications/Dynamic Enablers of Next-Generation Optical Communications Systems/Fast Optical Processing in Optical Transmission/VCSEL and Microcavity Lasers. 2002 IEEE/LEOS Summer Topi	all optical networking existing and emerging architecture and applications dynamic enablers of next generation optical communications systems fast optical processing in optical transmission vcsel and microcavity lasers 2002 ieee leos summer topi
B en M - Tijdschrift voor Politiek Beleid en Maatschappij	b en m tijdschrift voor politiek beleid en maatschappij
Business Intelligence Report : Cote d'Ivoire	business intelligence report cote divoire
Business Intelligence Report : Papua New Guinea (PNG)	business intelligence report papua new guinea png
Business and Incentive Strategies; B + I	business and incentive strategies b + i
Business View S.W. Florida	business view s w florida
BOAT/U.S. Magazine	boat u s magazine
B'or Ha'Torah	bor hatorah
Boletín de Antropología Americana	boletin de antropologia americana
Boletín de la Sociedad Venezolana de Espeleología	boletin de la sociedad venezolana de espeleologia
Biochimica et Biophysica Acta (BBA)/Lipids and Lipid Metabolism	biochimica et biophysica acta bba lipids and lipid metabolism